00000000000000000000
00000000000000000000
00000000000000000000
00000000000000000000
01111100000000111110
00000100000000100000
00000100000000100000
00000111000011100000
00000111000011100000
00000000000000000000
00000000000000000000
00000111000011100000
00000111000011100000
00000100000000100000
00000100000000100000
01111100000000111110
00000000000000000000
00000000000000000000
00000000000000000000
00000000000000000000