11110000111110001111
10000000001000000001
10000000001000000001
10000000001000000001
00000000001000000000
00000000001000000000
10000000001000000001
10000000001000000001
10000000001000000001
11111111111111111111
00000000000000000000
00000000000000000000
00000000000000000000
00000000000000000000
00000000000000000000
00000000000000000000
10000000000000000001
10000000000000000001
10000000000000000001
11110000111110001111