11110000000000001111
10000000000000000001
10000000000000000001
10000000000000000001
00000000000000000000
00000000000000000000
00000111111111100000
00000000000000000000
00000000000000000000
00000000000000000000
00000000000000000000
00000000000000000000
00000000000000000000
00000111111111100000
00000000000000000000
00000000000000000000
10000000000000000001
10000000000000000001
10000000000000000001
11110000000000001111