2200220022
3300330033
4400440044
3300330033
0000000000
0000000000



